1111111111111
100P000000001
10000C0000E01
1111111111111